*********
0       *
*       *
*       *
*********
